[Translation]
UserRegistrationHeader=הכנס את קוד המשתמש שקיבלת ממנהל הניסוי
ConfirmText=אשר
RegistrationCodeInputPlaceholder=הכנס קוד
StatisticsButton=סטטיסטיקה
NewGameButton=התחל משחק
TutorialHeader0=החלף מספרים על ידי לחיצה על מספר ואז על האחר. צבור נקודות וזמן על ידי יצירת סדרה של 3 מספרים זהים או יותר. כל החלפה שלא יוצרת סדרה תגרור הורדה של 5 נקודות
TutorialHeaderControl=ניתן לבצע החלפות בין 2 ריבועים צמודים על ידי לחיצה על אחד ואז על השני.צבור נקודות וזמן על ידי יצירת סדרה של 3 צבעים זהים או יותר. כל החלפה שלא יוצרת סדרה גוררת ירידה של 5 נקודות
TutorialHeader1=החלף מספרים על ידי לחיצה על מספר ואז על האחר. צבור נקודות וזמן על ידי יצירת סדרה של 3 מספרים שהמרחק בין כל ספרה הוא 1.יצירת סדרה של מספרים זהים מוסיפה זמן אך לא נקודות. כל החלפה שלא יוצרת סדרה תגרור הורדה של 5 נקודות
TutorialHeader2=החלף מספרים על ידי לחיצה על מספר ואז על האחר. צבור נקודות וזמן על ידי יצירת סדרה של 3 מספרים שהמרחק בין כל ספרה הוא 2.יצירת סדרה של מספרים זהים מוסיפה זמן אך לא נקודות. כל החלפה שלא יוצרת סדרה תגרור הורדה של 5 נקודות
Tutorial=שלב הדגמה
Date=תאריך
Score=ניקוד
Hour=שעה
LengthHeader=זמן משחק
SessionsHeader=סשן נוכחי
SessionTimeHeader=זמן נותר בסשן
LevelUpMessage=עלית לשלב
RegistrationErrorMessage=שגיאה בהתחברות לשרת. בדוק תקינות קוד וחיבור אינטרנט
Game_Over=המשחק הסתיים
Session_Ended=נגמר הזמן בסשן
Score=ניקוד
Round_Length=זמן משחק
Time=זמן
Level=שלב
Pause=השהייה
Menu=תפריט
NoMoreTimeInSession=הזמן משחק לסשן זה נגמר
TimeUntillNextSession=הזמן הנותר לסשן הבא
NoPlayerStatisticsLoaded=לא נטענו נתוני שחקן
Cancel=ביטול